#Sample EngineFile
#
#ENAME	name
#EMODEL	image
#MAXSPD	number //max speed
#ROTSPD	number //ship rotation
#HEALTH	
#ARMOR	
#PWRREQ	number
#SIZE 	number
#DESCRIP

ENAME	testEng
EMODEL
MAXSPD	100
ROTSPD	30
HEALTH	50
ARMOR	1
PWRREQ	0
SIZE	1
DESCRIP	testEngine is this