#Sample PowercoreFile
#
#PNAME	name
#PMODEL	image
#POWER	number //size of energy bar
#REGEN	how much energy regenerated per sec
#HEALTH	
#ARMOR	
#SIZE	number //size to determine if generator can fit into pylon?
#DESCRIP 
#END

PNAME	testCore
PMODEL	Resources/Sprites/Escort1-PylonPowerCore.png
POWER	100
REGEN	20
HEALTH	50
ARMOR	1
SIZE	1
DESCRIP	blah
END